R 800 800
NO ./textures/greystone.xpm
SO ./textures/redbrick.xpm
EA ./textures/wood.xpm
WE ./textures/wood.xpm
S ./textures/barrel.xpm
S3 ./textures/pot.xpm
S4 ./textures/pillar.xpm
EL ./maps/map.cub
C 255,200,160
F 122,122,122

11111111111111111
10000000000000001
10400000300000401
10000000000000001
10002000200020001
10000000000000001
10302020N02020301
10000000000000001
10002000200200001
10000000000000001
10400000300000401
10000000000000001
11111111111111111
