R 800 800
S2/home/user42/Documents/42/cub3d/textures/barrel.XPM
S3/home/user42/Documents/42/cub3d/textures/pot.xpm
S4/home/user42/Documents/42/cub3d/textures/pillar.XPM
SO/home/user42/Documents/42/cub3d/textures/mossy.XPM
NO/home/user42/Documents/42/cub3d/textures/mossy.XPM
EA/home/user42/Documents/42/cub3d/textures/greystone.XPM
EL/home/user42/Documents/42/cub3d/map 2.cub
WE/home/user42/Documents/42/cub3d/textures/greystone.XPM
F    220,20,60
C    21,30,61

        1111111111111111111111111
        1000000000110000000000001
        1011000001110000002000001
        10010000000000000000300N1
11111111101100000111000000000001
100000000011000001110111111111111
11110111111111011100000010001
11110111111111011101010010001
11000000110101011100000010001
10002000000000001100000010001
10000000000000001101010010001
1100000111010101111101111000111
11110111 1110101 101111010001
11111111 1111111 11111111111