R 800 800
S2/home/user42/Documents/42/cub3d/textures/barrel.XPM
S3/home/user42/Documents/42/cub3d/textures/greenlight.XPM
S4/home/user42/Documents/42/cub3d/textures/pillar.XPM
SO/home/user42/Documents/42/cub3d/textures/mossy.XPM
NO/home/user42/Documents/42/cub3d/textures/mossy.XPM
EA/home/user42/Documents/42/cub3d/textures/greystone.XPM
WE/home/user42/Documents/42/cub3d/textures/greystone.XPM
F    220,20,60
C    21,30,61

1111111
1444441
1E00031
1444441
1111111