R 800 800
S/home/user42/Documents/42/cub3d/textures/barrel.XPM
SO/home/user42/Documents/42/cub3d/textures/unnamed.XPM
NO/home/user42/Documents/42/cub3d/textures/brick_1.XPM
EA/home/user42/Documents/42/cub3d/textures/stone.XPM
WE/home/user42/Documents/42/cub3d/textures/wood.XPM
F    220,20,60
C    21,30,61

        1111111111111111111111111
        10000000001104W0200003001
        1011000001110000000000501
        1001000000000000002000001
111111111011000001110000000000401
100000000011000001110111111111111
11110111111111011100000010001
11110111111111011101010010001
11000000110101011100000010001
10002000000000001100000010001
10000000000000001101010010001
1100000111010101111101111000111
11110111 1110101 101111010001
11111111 1111111 11111111111