R 100 100
S2/home/user42/Documents/42/cub3d/textures/barrel.XPM
S3/home/user42/Documents/42/cub3d/textures/pot.xpm
S4/home/user42/Documents/42/cub3d/textures/pillar.XPM
SO/home/user42/Documents/42/cub3d/textures/mossy.XPM
NO/home/user42/Documents/42/cub3d/textures/mossy.XPM
EA/home/user42/Documents/42/cub3d/textures/greystone.XPM
WE/home/user42/Documents/42/cub3d/textures/greystone.XPM
F    220,20,60
C    21,30,61

1111111111111111111111111111
1000000000000000000000000001
1000000011111111111111000001
11111111            1000001
                   10000101
111111111111111111100000001
10000000E000000000000000001
100000000000000000000000001
110111111111111111100000001
10000111111110000011111111
1000000000000000001
1000000000000000001
1111111111111111111